11111111111111111111111111111111
10000000000000000000000000000001
10000000000000000000000000000001
10000000000000000000000000000001
10000000000000000000000000000001
10000000000000000000000000000001
10000011111111111111111111111111
10000010000000000000000001000001
10000010000000000000000001000001
10000010000000000000000001000001
10000010000000001000000001000001
10000010000000001000000001000001
10000010000000001000000001000001
10000010000000001000000001000001
10000000000000001000000000000001
10000000000000001000000000000001
10000000000000001000000000000001
11111111111111111111111111000001
10000000000000000000000000000001
10000000000000000000000000000001
10000000000000000000000000000001
10000000000000000000000000000001
10000000000000000000000000000001
11111111111111111111111111111111
